name	user_type
CNA	org
hiremaid.com.sg	org
The Straits Times	org
Eric Cheng	pers
ST Foreign Desk	org
TODAY	org
Laremie Tan	pers
Yahoo Singapore	org
Belinda	pers
Mothership.sg	org
Benedict Exconde	pers
AsiaOne	org
Ministry of Health	org
Shekhar Gupta	pers
Sense Hofstede	pers
Singapore Italian Association	org
Breaking Market News	org
First Squawk	org
Scotts Digital	org
TOC News	org
Automatic Blogging	org
24x7	org
MustShareNews	org
The New Paper	org
sapsonic	org
viswa_mfame_guru	org
The Independent	org
MEDICI Global	org
ST Business Desk	org
ST Sports Desk	org
COVID19 in Asia-Pacific	org
rajsgpe	pers
Ericssen	pers
Haseenah Koyakutty	pers
Singapore Tweetings	org
EurekaMag	org
Diag Bacteriology	org
Human Resources Online	org
Luca Dellanna	pers
TheFinance.sg	org
Nibras Adambawa	pers
Singapore Government	org
Darryl Kang	pers
Continuum Economics	org
DailyFX Team Live	org
AsiaInsuranceReview	org
Peter Ong	pers
Karen M. Fu	pers
BBC Asia	org
Tax Guy	pers
AlgoTrader	org
GourmetMale - we had 19 months	pers
Straits Times Life	org
CNBC Int'l PR	org
Tan Kok Leong	pers
iwan1979	pers
Captain Singh, FICArb, 73K	pers
The American Chamber of Commerce in Singapore	org
Youth.SG	org
Systemic Sarcasm	pers
E D Jaworska	org
Hermes strategygroup	org
Michelle Wonderland (Castillo)	pers
Alexander Arifianto	pers
Asian Aviation	org
eFeedLink	org
A Chronic Voice	org
SGXcafe	org
INSEAD Knowledge	org
Hemant Prasad	pers
Singapore To Bali	org
BioSpectrumAsia	org
AlCircle	org
Skyhigh.VIP	org
My Vote My Voice	org
"""I admire a Chinese dictatorship"" - Justin Trudeau"	pers
Vijay Karanam	pers
william adams	pers
Microsoft Asia	org
The Edge Singapore	org
Lyall Taylor	pers
Peter Hoskins	pers
Silentmax	pers
Uresh Perera (UP)	pers
Jib	pers
David Yin	pers
INmarketing	org
ST Opinion	org
Anndy Lian	pers
Lewis Garrad	pers
Alvin Lee	pers
Yan Kow Cheong	pers
TheRealFourSeasonsTotalLandscaping	pers
Charles Yeo	pers
Andy Wheatley	pers
Derek Wallbank	org
Patchouli Woollahra	pers
Mandy in a mask Jeyaretnam	pers
HRD Asia	org
GovInsider	org
Anne Lochoff	pers
Manu Bhaskaran	pers
enghou	pers
covid19live	org
BowdyWanders	pers
Goody Feed	org
M. S. M. Saifullah	pers
Experian DataLab #StaySafe	org
finews_asia	org
Joseph Chun	pers
Yummy S.	pers
Chua Chin Hon	pers
Al Cadena	pers
Gerry Doyle	pers
laxmi narayan naik	pers
K C Yan	pers
Bandwagon	org
Analyse Asia	org
AVPN	org
Let's Talk Singapore	org
Coconuts Singapore	org
Nirav Kanodra	pers
Econsultancy	org
Institute for Management Development (IMD)	org
Neil Humphreys	pers
Baolau	org
james crabtree	pers
Moovaz	org
A . Vijay M.A., M.Phil., D.C.E.,	pers
Joslin Vethakumar	pers
Dr. Suchitra Kataria	pers
Boon Chuan	pers
Ravi Romo	pers
Wanjin Hong	pers
justin adam lee	pers
KrASIA	org
Sakamoto Math	pers
FoodNavAsia	org
Credevo	org
Travel Weekly Asia	org
Abhas K. Jha	pers
The Morning Context	org
Dawn Xiana Moon	pers
Wolfram Hedrich	pers
EY Singapore	org
W.	pers
Singapore Lite	org
shahnawaz adenwala	pers
Michelle Vin	pers
vin	pers
Audi Khalid	pers
SAMEERind	pers
Eric J. Brooks	pers
SGFirstAid	org
Paperless News	org
DFDL Legal and Tax	org
Tim Hentschel	pers
Tony Nash	pers
Sarah Coldheart	pers
Claudia Siregar	pers
Jonah Blank	pers
RSIS	org
Steve Barge	pers
HardwareZone	org
HR in ASIA	org
President M.A.O President of Sierra Leone	pers
Gurdip Singh	pers
Fashion Studio	org
Samsul Bahari Mencari Link Download Video Bokep OK	pers
Digital Nomad	pers
ShankarM	pers
Marvin LFC *	pers
Kwan Jin Yao	pers
NutraIngredientsAsia	org
Eco-Business	org
Marcel & Ginette	pers
Manish Sharma	pers
NUS Medicine	org
Benjamin Chiang	pers
HRM Asia	org
Infoblaze Southeast Asia	org
LividEye Yoshikawa	pers
Jonathan Yabut	pers
S J Hopkins	pers
Kam-Yung Soh	pers
moneyfm893	org
MK	pers
Ethan Lou	pers
TTG Asia	org
U.S. Embassy Singapore	org
Collin Koh	pers
Alejandro Pescador	pers
Global Trade Review	org
Dezan Shira & Associates	org
FII News	org
ISEAS - Yusof Ishak Institute	org
Based Malaya_Singapore	org
Antonio Fatas	pers
Conventus Singapore	org
CrescentRating	org
Cranky Mama	pers
NICE Actimize	org
Ravi Parthasarathy	pers
Rehman A	pers
EdgeProp SG	org
MFA Consular	org
Darryl	pers
AquacultureSg	org
Timothy McDonald	pers
Sham Majid	pers
Honeycombers	org
Panadol	pers
Sigit Adinugroho	pers
athena zaw	pers
PravasiExpress	org
Parminder Singh	pers
Teymoor Nabili	pers
mirax	pers
Vicky Makhija	pers
Insider Asia	org
NZSg	pers
Faizal Pahmee	pers
Sara James	pers
Dr N Howard	pers
Alex Koh	pers
shukla	pers
Qasim	pers
InvoiceInterchange	org
Duke-NUS Medical School	org
Covan Tai	pers
So Japan	org
JFs Musings from....	pers
mentalmarketer	pers
Aziz	pers
APEC Secretariat	org
Karen Teoh	pers
Francis	pers
Bryan Cheong	pers
dotlah!	org
Ra	pers
Middle East Inst-NUS	org
